7,27,26,16,18,16,9,18
16,19,7,7,17,29,18,9
16,7,29,26,9,18,18,28
7,26,6,9,29,16,28,19
29,18,26,16,8,28,26,18
27,18,9,6,8,28,17,19
27,18,9,18,17,8,6,9
28,26,16,16,6,29,19,7
