19,6,18,18,8,9,28,6,18,6,6,27,19,6,6,18
27,9,27,19,26,26,6,26,18,27,18,27,8,27,26,8
6,18,27,28,29,8,26,17,16,27,29,29,6,19,26,6
17,19,9,9,26,16,9,18,29,19,9,18,17,9,17,8
16,17,19,17,19,26,7,18,27,7,9,27,19,17,16,26
29,29,26,6,6,7,17,26,19,27,17,7,8,9,17,7
16,16,29,8,6,27,18,26,18,27,27,27,29,9,7,29
9,17,17,17,6,9,8,9,17,29,27,9,28,16,19,16
