27,18,18,9,8,29,9,27,6,18,9,6
16,18,27,19,8,18,18,18,18,8,26,16
28,26,28,29,6,18,6,19,9,16,26,27
16,9,19,18,7,28,19,8,18,6,17,26
27,8,19,19,28,7,26,8,19,18,19,18
16,6,26,17,16,19,7,27,19,28,27,6
26,7,8,18,7,9,6,8,8,8,18,6
18,19,19,28,18,7,9,6,9,17,28,27
28,19,6,7,27,16,26,28,9,9,18,7
19,18,9,29,6,9,8,29,19,27,28,27
9,29,28,19,9,26,26,16,26,19,26,16
8,26,16,19,18,27,9,27,27,7,9,18
